1111111111
10000000E1
1P1C1CCCC1
1111111111

1111111111
1000000001
1111111111
